GMMMGGGGMGGMMMM
GMMGGMMGMGGMMMM
GGGGMMMGMGMMGGG
GMMGMMMGGGGGGMG
GGMGGMMMMMMGMMG
MGGGMMGGGGGGMMG
MMGMMMGGMMMGMMB
MMGMMMMMMMMGMMA
MGGMMMGGGMGGMMM
GGMMMMGMGMGMMMM
GMMMMGGMGGGMMMM
GGMMGGMMMGMMMMM
MGGGGMMGGGGGMMM
MMMMMMMGGPGGMMM
MMMMMMMMGMMMMMM
